PEOPLE.TABS.RESOURCE_PLAN	Resource Plan
PEOPLE.TABS.RESOURCE_ALLOCATION	Resource Allocation
PEOPLE.TABS.RESOURCE_SUMMARY	Resource Summary
PEOPLE.RESOURCE_PLAN.UPDATE_RESOURCES_BUTTON	Update Resources
PEOPLE.RESOURCE_PLAN.UPDATE_SUCCESS	Resource plan was successfully updated
PEOPLE.RESOURCE_ALLOCATION.PARTICIPANT_PROJECT_ROLE.INSTRUCTIONAL_DESIGNER	Instructional Designer
PEOPLE.RESOURCE_ALLOCATION.PARTICIPANT_PROJECT_ROLE.LEARNING_DEVELOPER	Learning Developer
PEOPLE.RESOURCE_ALLOCATION.PARTICIPANT_PROJECT_ROLE.MEDIA_DEVELOPER	Media Developer
PEOPLE.RESOURCE_ALLOCATION.PARTICIPANT_PROJECT_ROLE.CONTENT_WRITER	Content Writer
PEOPLE.RESOURCE_ALLOCATION.PARTICIPANT_PROJECT_ROLE.PRODUCER	Producer
PEOPLE.RESOURCE_ALLOCATION.PARTICIPANT_PROJECT_ROLE.QA	QA
PEOPLE.RESOURCE_ALLOCATION.PARTICIPANT_PROJECT_ROLE.TRAINER	Trainer/Facilitator
PEOPLE.RESOURCE_ALLOCATION.PARTICIPANT_PROJECT_ROLE.LEARNING_CONSULTANT	Learning Consultant/Partner
PEOPLE.RESOURCE_ALLOCATION.PARTICIPANT_PROJECT_ROLE.REPORTING_ANALYST	Reporting Analyst
PEOPLE.RESOURCE_ALLOCATION.PARTICIPANT_PROJECT_ROLE.TRAINING_COORDINATOR	Training Coordinator
PEOPLE.RESOURCE_ALLOCATION.PARTICIPANT_PROJECT_ROLE.LMS_ADMIN	LMS Admin/Support
PEOPLE.RESOURCE_ALLOCATION.PARTICIPANT_PROJECT_ROLE.PROJECT_MANAGER	Project Manager
PEOPLE.RESOURCE_ALLOCATION.PARTICIPANT_PROJECT_ROLE.PROGRAM_MANAGER	Program Manager
PEOPLE.RESOURCE_ALLOCATION.PARTICIPANT_PROJECT_ROLE.RESOURCE_MANAGER	Resource Manager
PEOPLE.RESOURCE_ALLOCATION.PARTICIPANT_PROJECT_ROLE.COMMUNICATION_SPECIALIST	Communication Specialist
PEOPLE.RESOURCE_ALLOCATION.PARTICIPANT_PROJECT_ROLE.EXECTIVE_SPOSNOR	Executive Sponsor
PEOPLE.RESOURCE_ALLOCATION.PARTICIPANT_PROJECT_ROLE.SME	SME
PEOPLE.RESOURCE_ALLOCATION.PARTICIPANT_PROJECT_ROLE.REVIEWER	Reviewer
PEOPLE.RESOURCE_ALLOCATION.PARTICIPANT_PROJECT_ROLE.OTHERS	Others
PEOPLE.RESOURCE_ALLOCATION.PARTICIPANT_PROJECT_ROLE.PROJECT_OWNER	Project Owner
PEOPLE.RESOURCE_ALLOCATION.ADD_PARTICIPANT_MODAL.TITLE	Add Participant
PEOPLE.RESOURCE_ALLOCATION.ADD_PARTICIPANT_MODAL.UPDATE_ROLE	Update Role
PEOPLE.RESOURCE_ALLOCATION.ADD_PARTICIPANT_MODAL.PROJECT_PARTICIPANT_FIELD_LABEL	Project Participant
PEOPLE.RESOURCE_ALLOCATION.ADD_PARTICIPANT_MODAL.PROJECT_PARTICIPANT_FIELD_PLACEHOLDER	Add a participant
PEOPLE.RESOURCE_ALLOCATION.ADD_PARTICIPANT_MODAL.DESCRIPTION	 Fill in the details to add resource to project
PEOPLE.RESOURCE_ALLOCATION.ADD_PARTICIPANT_MODAL.PARTICIPANT_TYPE_FIELD_LABEL	Participant Type
PEOPLE.RESOURCE_ALLOCATION.ADD_PARTICIPANT_MODAL.PARTICIPANT_TYPE_FIELD_PLACEHOLDER	Select a project role
PEOPLE.RESOURCE_ALLOCATION.ADD_PARTICIPANT_MODAL.PARTICIPANT_TYPE_FIELD_OPTIONS.MEMBER	Project Member
PEOPLE.RESOURCE_ALLOCATION.ADD_PARTICIPANT_MODAL.PARTICIPANT_TYPE_FIELD_OPTIONS.COLLABORATOR	Project Collaborator
PEOPLE.RESOURCE_ALLOCATION.ADD_PARTICIPANT_MODAL.PARTICIPANT_ROLE_FIELD_LABEL	Project Role
PEOPLE.RESOURCE_ALLOCATION.ADD_PARTICIPANT_MODAL.PARTICIPANT_ROLE_FIELD_PLACEHOLDER	Select a job role to add resource
PEOPLE.RESOURCE_ALLOCATION.ADD_PARTICIPANT_MODAL.PARTICIPANT_START_DATE_FIELD_LABEL	Start Date
PEOPLE.RESOURCE_ALLOCATION.ADD_PARTICIPANT_MODAL.PARTICIPANT_END_DATE_FIELD_LABEL	End Date
PEOPLE.RESOURCE_ALLOCATION.ADD_PARTICIPANT_MODAL.PARTICIPANT_END_DATE_FIELD_PLACEHOLDER	Completion Date
PEOPLE.RESOURCE_ALLOCATION.ADD_PARTICIPANT_MODAL.PARTICIPANT_USER_FIELD_LABEL	User
PEOPLE.RESOURCE_ALLOCATION.ADD_PARTICIPANT_MODAL.PARTICIPANT_USER_FIELD_PLACEHOLDER	Select a user
PEOPLE.RESOURCE_ALLOCATION.ADD_PARTICIPANT_MODAL.PARTICIPANT_TOTAL_AVAILABILITY	Total Availability
PEOPLE.RESOURCE_ALLOCATION.ADD_PARTICIPANT_MODAL.PARTICIPANT_TOTAL_ALLOCATED_HOURS	Total Allocated Hours
PEOPLE.RESOURCE_ALLOCATION.ADD_PARTICIPANT_MODAL.PARTICIPANT_ESTIMATED_HOURS_NEEDED	Estimated hours needed
PEOPLE.RESOURCE_ALLOCATION.ADD_PARTICIPANT_MODAL.PARTICIPANT_ADDED_SUCCESS_MESSAGE	New participant was succesfully added to the team!
PEOPLE.RESOURCE_ALLOCATION.ADD_PARTICIPANT_MODAL.AVAILABLE	Available
PEOPLE.RESOURCE_ALLOCATION.ADD_PARTICIPANT_MODAL.HOURS_AVAILABLE	{hours} h
PEOPLE.RESOURCE_ALLOCATION.ADD_PARTICIPANT_MODAL.TOTAL_ALLOCATION_PLACEHOLDER	Allocation
PEOPLE.RESOURCE_ALLOCATION.ADD_PARTICIPANT_MODAL.ADD_USER	Add a user
PEOPLE.RESOURCE_ALLOCATION.ADD_PARTICIPANT_MODAL.SELECT_ROLE	Select a role
PEOPLE.RESOURCE_ALLOCATION.ADD_PARTICIPANT_MODAL.PARTICIPANT_ADDED_SUCCESS_SNACKBAR_MESSAGE	Success! Participant added.
PEOPLE.RESOURCE_ALLOCATION.ADD_PARTICIPANT_MODAL.PARTICIPANT_UPDATED_SUCCESS_SNACKBAR_MESSAGE	Success! Participant info updated.
PEOPLE.RESOURCE_ALLOCATION.TABLE.ALLOCATION	Allocation
PEOPLE.RESOURCE_ALLOCATION.TABLE.OVERALLOCATION	Overallocation
PEOPLE.RESOURCE_ALLOCATION.TABLE.TIME_OFF_HOLIDAYS	Time Off / Holidays
PEOPLE.RESOURCE_ALLOCATION.TABLE.OWNERS	{num, plural, =0 {Owner} =1 {Owners}}
PEOPLE.RESOURCE_ALLOCATION.TABLE.MEMBERS	{num, plural, =0 {Member} =1 {Members}}
PEOPLE.RESOURCE_ALLOCATION.TABLE.COLLABORATORS	{num, plural, =0 {Collaborator} =1 {Collaborators}}
PEOPLE.RESOURCE_ALLOCATION.TABLE.EMPTY_OWNERS	No owner added yet.
PEOPLE.RESOURCE_ALLOCATION.TABLE.EMPTY_MEMBERS	No member added yet.
PEOPLE.RESOURCE_ALLOCATION.TABLE.EMPTY_COLLABORATORS	No collaborators added yet.
PEOPLE.RESOURCE_ALLOCATION.TABLE.VIEW_TASKS	View Tasks
PEOPLE.RESOURCE_ALLOCATION.TABLE.HIDE_TASKS	Hide Tasks
PEOPLE.RESOURCE_ALLOCATION.TABLE.HEADERS.PROJECT_TEAM	Project Team
PEOPLE.RESOURCE_ALLOCATION.TABLE.HEADERS.PROJECT_ROLE	Project Role
PEOPLE.RESOURCE_ALLOCATION.TABLE.HEADERS.ALLOCATION	{isMember, plural, =0 {Est.} =1 {Total}} Allocation
PEOPLE.RESOURCE_ALLOCATION.TABLE.HEADERS.TIME_LINE	Timeline
PEOPLE.RESOURCE_ALLOCATION.TABLE.HEADERS.PARTICIPANT_TYPE	Participant Type
PEOPLE.RESOURCE_ALLOCATION.TABLE.HEADERS.PARTICIPANT_TOTAL	Participant Total
PEOPLE.RESOURCE_ALLOCATION.TABLE.HEADERS.NAME	Name
PEOPLE.RESOURCE_ALLOCATION.TABLE.HEADERS.WEEKLY_TOTAL	Weekly Total (collaborator not included)
PEOPLE.RESOURCE_ALLOCATION.TABLE.HEADERS.ACTUAL_HOURS	Actual Hours
PEOPLE.RESOURCE_ALLOCATION.TABLE.TEAM_MANAGER_ASSIGNMENT	A user cannot be a team manager and a team member of the same team.
PEOPLE.RESOURCE_ALLOCATION.TABLE.ALLOCATION_TIME	{allocation}h
PEOPLE.RESOURCE_ALLOCATION.TABLE.ALLOCATION_AVAILABILITY	({availability} avail)
PEOPLE.RESOURCE_ALLOCATION.TABLE.ALLOCATION_HOURS	{hours}hours
PEOPLE.RESOURCE_ALLOCATION.TABLE.ASSIGNMENT_ESTIMATED_TIME	Estimated hours: {estimated} h
PEOPLE.RESOURCE_ALLOCATION.TABLE.ASSIGNMENT_ACTUAL_TIME	Actual hours: {hours} h
PEOPLE.RESOURCE_ALLOCATION.TABLE.COLLABORATOR_ESTIMATED_TIME	Est. {hours}h total
PEOPLE.RESOURCE_ALLOCATION.TABLE.ADJUST_ALLOCATION	Adjust allocation
PEOPLE.RESOURCE_ALLOCATION.TABLE.UPDATE_ASSIGNMENT	Update { type } assignment
PEOPLE.RESOURCE_ALLOCATION.TABLE.ASSIGNMENT_DETAILS	Assignment details
PEOPLE.RESOURCE_ALLOCATION.TABLE.ADD_ASSIGNMENT	Add New Assignment
PEOPLE.RESOURCE_ALLOCATION.TABLE.NEW_ASSIGNMENT	New member assignment
PEOPLE.RESOURCE_ALLOCATION.TABLE.ASSIGNMENT_UPDATED_SUCCESSFULLY	Project {type} assignment was successfully updated!
PEOPLE.RESOURCE_ALLOCATION.TABLE.REVIEW_ALLOCATION_WARNING	You may need to review this user's allocation.
PEOPLE.RESOURCE_ALLOCATION.TABLE.REMOVE_USER_WARNING_TOOLTIP	 By removing this role, the user will be removed from the project.
PEOPLE.RESOURCE_ALLOCATION.TABLE.REMOVE_USER_WARNING	By removing this role, the user will be removed from the project. Cancel this action if this is not desired.
PEOPLE.RESOURCE_ALLOCATION.TABLE.REMOVE_PROJECT_OWNER_ROLE_WARNING	To remove this assignment the user needs to be removed as Owner from the Overview page
PEOPLE.RESOURCE_ALLOCATION.TABLE.NO_ASSIGNMENT	No assignment
PEOPLE.RESOURCE_ALLOCATION.TABLE.REMOVE_STARTED_ROLE_WARNING	Removing this project role will remove the worked hours from the project. To keep record of worked hours, adjust the timeline instead of removing the role.
PEOPLE.RESOURCE_ALLOCATION.TABLE.REMOVE_STARTED_ROLE_WARNING_TOOLTIP	Removing this project role will remove the worked hours from the project. To keep record of worked hours, adjust the timeline instead of removing the role.
PEOPLE.RESOURCE_ALLOCATION.TABLE.TIME_OFF_TOOLTIP	Time off/Holiday this week
PEOPLE.RESOURCE_ALLOCATION.TABLE.TARGET_COMPLETION	Target Completion
PEOPLE.RESOURCE_ALLOCATION.TABLE.REMOVE_PARTICIPANT	Remove Participant
PEOPLE.RESOURCE_ALLOCATION.TABLE.SECTIONS.OWNER	Owner
PEOPLE.RESOURCE_ALLOCATION.TABLE.SECTIONS.EMPTY_OWNER	No owner users added yet
PEOPLE.RESOURCE_ALLOCATION.TABLE.SECTIONS.LD	Learning
PEOPLE.RESOURCE_ALLOCATION.TABLE.SECTIONS.EMPTY_LD	No learning users added yet
PEOPLE.RESOURCE_ALLOCATION.TABLE.SECTIONS.BUSINESS	Business
PEOPLE.RESOURCE_ALLOCATION.TABLE.SECTIONS.EMPTY_BUSINESS	No business users added yet
PEOPLE.RESOURCE_ALLOCATION.TABLE.SECTIONS.EXTERNAL	External
PEOPLE.RESOURCE_ALLOCATION.TABLE.SECTIONS.EMPTY_EXTERNAL	No external users added yet
PEOPLE.RESOURCE_ALLOCATION.TABLE.SECTIONS.FACILITATOR	Facilitator
PEOPLE.RESOURCE_ALLOCATION.TABLE.SECTIONS.EMPTY_FACILITATOR	No facilitator users added yet
PEOPLE.RESOURCE_ALLOCATION.TABLE.NO_ROLE	No role assigned
PEOPLE.RESOURCE_ALLOCATION.TABLE.NO_TASKS	No tasks assigned
PEOPLE.RESOURCE_ALLOCATION.TABLE.PROJECT_OWNER_ROLE	Project Owner
PEOPLE.RESOURCE_ALLOCATION.REMOVE_PARTICIPANT_MODAL.TITLE	Remove Participant
PEOPLE.RESOURCE_ALLOCATION.REMOVE_PARTICIPANT_MODAL.DESCRIPTION	You are about to remove this participant from this project.<br> They will <b>no longer have access</b> to the project and they will be<br> <b>unassigned from all tasks.</b>
PEOPLE.RESOURCE_ALLOCATION.REMOVE_PARTICIPANT_MODAL.REMOVE	Remove Participant
PEOPLE.RESOURCE_ALLOCATION.REMOVE_PARTICIPANT_MODAL.PARTICIPANT_REMOVED_SUCCESS_SNACKBAR_MESSAGE	Success! Participant removed
PEOPLE.RESOURCE_ALLOCATION.UPDATE_WEEKLY_ALLOCATION_MODAL.SUCCESS_BANNER	Project member allocation hours were successfully updated!
PEOPLE.RESOURCE_ALLOCATION.UPDATE_WEEKLY_ALLOCATION_MODAL.HOUR_LABEL	h
PEOPLE.RESOURCE_ALLOCATION.UPDATE_WEEKLY_ALLOCATION_MODAL.TIME_LINE	Timeline
PEOPLE.RESOURCE_ALLOCATION.UPDATE_WEEKLY_ALLOCATION_MODAL.PROJECT_ROLE	Project Role
PEOPLE.RESOURCE_ALLOCATION.UPDATE_WEEKLY_ALLOCATION_MODAL.HOURS_ALLOCATED	Hours Allocated
PEOPLE.RESOURCE_ALLOCATION.UPDATE_WEEKLY_ALLOCATION_MODAL.HOURS_LEFT	Hours Left
PEOPLE.RESOURCE_ALLOCATION.UPDATE_WEEKLY_ALLOCATION_MODAL.ACTUAL_HOURS	Actual Hours
PEOPLE.RESOURCE_SUMMARY.RESOURCE_SUMMARY_TABLE.TITLE	Resource Summary by Resource Type
PEOPLE.RESOURCE_SUMMARY.RESOURCE_SUMMARY_TABLE.SUB_TITLE	This section shows total of allocated hours and actual hours to date of project members and collaborators
PEOPLE.RESOURCE_SUMMARY.RESOURCE_SUMMARY_TABLE.MEMBERS_SECTION	Members
PEOPLE.RESOURCE_SUMMARY.RESOURCE_SUMMARY_TABLE.COLLABORATORS_SECTION	Collaborators
PEOPLE.RESOURCE_SUMMARY.RESOURCE_SUMMARY_TABLE.PROJECT_ROLE_COLUMN	Project Role
PEOPLE.RESOURCE_SUMMARY.RESOURCE_SUMMARY_TABLE.NO_OF_RESOURCE_COLUMN	No. of Resources
PEOPLE.RESOURCE_SUMMARY.RESOURCE_SUMMARY_TABLE.TOTAL_HOURS_COLUMN	Total Allocated Hours
PEOPLE.RESOURCE_SUMMARY.RESOURCE_SUMMARY_TABLE.TOTAL_ACTUAL_HOURS	Total Actual Hours
PEOPLE.RESOURCE_SUMMARY.RESOURCE_SUMMARY_TABLE.TOTAL	Total
PEOPLE.RESOURCE_SUMMARY.TASKS_SUMMARY_TABLE.TITLE	Resources Summary by Task Type 
PEOPLE.RESOURCE_SUMMARY.TASKS_SUMMARY_TABLE.SUB_TITLE	This section shows total of allocated and actual hours to date by task type
PEOPLE.RESOURCE_SUMMARY.TASKS_SUMMARY_TABLE.TASK_TYPE	Task Type
PEOPLE.RESOURCE_SUMMARY.TASKS_SUMMARY_TABLE.NUMBER_OF_TASKS	No. of Tasks
PEOPLE.RESOURCE_SUMMARY.TASKS_SUMMARY_TABLE.TOTAL_ESTIMATED_HOURS	Total Estimated Hours
PEOPLE.RESOURCE_SUMMARY.TASKS_SUMMARY_TABLE.TOTAL_ACTUAL_HOURS	Total Actual Hours
PEOPLE.RESOURCE_SUMMARY.TASKS_SUMMARY_TABLE.EMPTY_TABLE	No data to display as no tasks added yet.
EMPLOYMENT_TYPE.TITLE	Employment Type
EMPLOYMENT_TYPE.FULL_TIME	Full Time
EMPLOYMENT_TYPE.PART_TIME	Part Time
EMPLOYMENT_TYPE.INTERN	Intern
EMPLOYMENT_TYPE.CONTRACTOR	Contractor
TEAMS.TEAM	Team
TEAMS.CAPACITY	Capacity
TEAMS.TABLE.TEAM_MEMBERS	Team Members
TEAMS.TABLE.JOB_TITLE	Job Title
TEAMS.TABLE.EMPLOYMENT_TYPE	Employment type
TEAMS.TABLE.COUNTRY	Country
TEAMS.TABLE.HOURLY_RATE	Hourly Rate
TEAMS.TABLE.TEAM_MANAGER	Team Manager
TEAMS.UPDATE_MENU.UPDATE_INFO	Update Information
TEAMS.UPDATE_MENU.MANAGE_TIME_OFF	Manage Time Off
TEAMS.UPDATE_MODAL.EMAIL_ID	Email ID
TEAMS.UPDATE_MODAL.JOB_TITLE	Job Title
TEAMS.UPDATE_MODAL.RATE_PER_HOUR	Rate Per Hour
TEAMS.UPDATE_MODAL.COUNTRY	Country
TEAMS.UPDATE_MODAL.EMPLOYMENT_TYPE	Employment type
TEAMS.UPDATE_MODAL.WEEKLY_CAPACITY	Default Weekly Capacity
TEAMS.UPDATE_MODAL.JOB_FUNCTIONS	Job Functions
TEAMS.UPDATE_MODAL.LANGUAGES	Language(s)
TEAMS.UPDATE_MODAL.SKILLS	Skills
TEAMS.UPDATE_MODAL.HRS	hrs
TEAMS.CURRENCY	USD
TEAMS.SAVE	Save
TEAMS.EMPLOYMENT_TYPE.FULL_TIME	Full Time
TEAMS.EMPLOYMENT_TYPE.PART_TIME	Part Time
TEAMS.EMPLOYMENT_TYPE.INTERN	Intern
TEAMS.EMPLOYMENT_TYPE.CONTRACTOR	Contractor
TEAMS.EMPLOYMENT_TYPE.UNDEFINED	Not Assigned
TEAMS.SKILLS.ACCOUNT_MANAGEMENT	Account Management
TEAMS.SKILLS.ANIMATION	Animation
TEAMS.SKILLS.ASSESSMENT_CREATION	Assessment Creation
TEAMS.SKILLS.AUDIO_EDITING	Audio Editing
TEAMS.SKILLS.BRAND_DEVELOPMENT	Brand Development
TEAMS.SKILLS.BUSINESS_ANALYSIS	Business Analysis
TEAMS.SKILLS.BUSINESS_DEVELOPMENT	Business Development
TEAMS.SKILLS.BUSINESS_INTELLIGENCE	Business Intelligence
TEAMS.SKILLS.BUSINESS_RELATION_MANAGEMENT	Business Relation Management
TEAMS.SKILLS.CASCADING_STYLE_SHEETS	Cascading Style Sheets
TEAMS.SKILLS.CHANGE_MANAGEMENT	Change Management
TEAMS.SKILLS.COACHING	Coaching
TEAMS.SKILLS.COMMUNICATION	Communication
TEAMS.SKILLS.CONSULTING	Consulting
TEAMS.SKILLS.CONTENT_MANAGEMENT_SYSTEM	Content Management System
TEAMS.SKILLS.CONTENT_WRITING_EDITING	Content Writing/Editing
TEAMS.SKILLS.CONTRACT_MANAGEMENT	Contract Management
TEAMS.SKILLS.COORDINATION	Coordination
TEAMS.SKILLS.CURRICULUM_DESIGN_DEVELOP	Curriculum Design/Develop
TEAMS.SKILLS.DATA_ANALYSIS	Data Analysis
TEAMS.SKILLS.DATABASE	Database
TEAMS.SKILLS.DIGITAL_MARKETING	Digital Marketing
TEAMS.SKILLS.E_LEARNING	E-learning
TEAMS.SKILLS.EVALUATION	Evaluation
TEAMS.SKILLS.EVENT_MANAGEMENT	Event Management
TEAMS.SKILLS.GOVERNANCE	Governance
TEAMS.SKILLS.GRAPHIC_DESIGN	Graphic Design
TEAMS.SKILLS.INTAKE_MANAGEMENT	Intake Management
TEAMS.SKILLS.FACILITATION	Facilitation
TEAMS.SKILLS.FINANCIAL_ANALYSIS	Financial Analysis
TEAMS.SKILLS.FINANCIAL_MANAGEMENT	Financial Management
TEAMS.SKILLS.HTML5	HTML5
TEAMS.SKILLS.HUMAN_RESOURCE_MANAGEMENT_SYSTEM	Human Resource Management System
TEAMS.SKILLS.INFORMATION_ARCHITECTURE	Information Architecture
TEAMS.SKILLS.INSTRUCTIONAL_DESIGN	Instructional Design
TEAMS.SKILLS.JAVASCRIPT	Javascript
TEAMS.SKILLS.LEADERSHIP	Leadership
TEAMS.SKILLS.LEARNING_MANAGEMENT_SYSTEM	Learning Management System
TEAMS.SKILLS.MARKETING	Marketing
TEAMS.SKILLS.MEASUREMENT	Measurement
TEAMS.SKILLS.MOBILE_APP_DESIGN	Mobile App Design
TEAMS.SKILLS.MOBILE_APP_DEVELOPMENT	Mobile App Development
TEAMS.SKILLS.PEOPLE_ANALYTICS	People Analytics
TEAMS.SKILLS.PERFORMANCE_MANAGEMENT	Performance Management
TEAMS.SKILLS.PHOTOGRAPHY	Photography
TEAMS.SKILLS.PLANNING	Planning
TEAMS.SKILLS.PROCESS_IMPROVEMENT	Process Improvement
TEAMS.SKILLS.PRODUCT_MANAGEMENT	Product Management
TEAMS.SKILLS.PROGRAMMING	Programming
TEAMS.SKILLS.PROJECT_MANAGEMENT	Project Management
TEAMS.SKILLS.PROOFREADING	Proofreading
TEAMS.SKILLS.QUALITY_ASSURANCE	Quality Assurance
TEAMS.SKILLS.REPORTING	Reporting
TEAMS.SKILLS.RESEARCH	Research
TEAMS.SKILLS.REQUIREMENT_GATHERING	Requirement Gathering
TEAMS.SKILLS.REQUIREMENT_ANALYSIS	Requirement Analysis
TEAMS.SKILLS.RESOURCE_MANAGEMENT	Resource Management
TEAMS.SKILLS.SEARCH_ENGINE_OPTIMIZATION	Search Engine Optimization
TEAMS.SKILLS.SOCIAL_MEDIA	Social Media
TEAMS.SKILLS.SOCIAL_MEDIA_MARKETING	Social Media Marketing
TEAMS.SKILLS.SOFTWARE_ADOBE_PHOTOSHOP	Software - Adobe Photoshop
TEAMS.SKILLS.SOFTWARE_ADOBE_ILLUSTRATOR	Software - Adobe Illustrator
TEAMS.SKILLS.SOFTWARE_ADOBE_CAPTIVATE	Software - Adobe Captivate
TEAMS.SKILLS.SOFTWARE_ARTICULATE	Software - Articulate
TEAMS.SKILLS.SOFTWARE_CAMTASIA	Software - Camtasia
TEAMS.SKILLS.SOFTWARE_EASYGENERATOR	Software - Easygenerator
TEAMS.SKILLS.SOFTWARE_ELUCIDAT	Software - Elucidat
TEAMS.SKILLS.SOFTWARE_ISPRING_SUITE	Software - iSpring Suite
TEAMS.SKILLS.SOFTWARE_LECTORA	Software - Lectora
TEAMS.SKILLS.SOFTWARE_MICROSOFT_WORD	Software - Microsoft Word
TEAMS.SKILLS.SOFTWARE_MICROSOFT_POWERPOINT	Software - Microsoft PowerPoint
TEAMS.SKILLS.SOFTWARE_MICROSOFT_EXCEL	Software - Microsoft Excel
TEAMS.SKILLS.SOFTWARE - SHAREPOINT	Software - SharePoint
TEAMS.SKILLS.SURVEY_DESIGN	Survey Design
TEAMS.SKILLS.TALENT_MANAGEMENT	Talent Management
TEAMS.SKILLS.TEAM_MANAGEMENT	Team Management
TEAMS.SKILLS.TRAINING_DELIVERY	Training Delivery
TEAMS.SKILLS.UX_DESIGN	UX Design
TEAMS.SKILLS.UX_RESEARCH	UX Research
TEAMS.SKILLS.USABILITY TESTING	Usability Testing
TEAMS.SKILLS.VENDOR_MANAGEMENT	Vendor Management
TEAMS.SKILLS.VIDEO_EDITING	Video Editing
TEAMS.SKILLS.VIRTUAL_REALITY	Virtual Reality
TEAMS.SKILLS.WEB_DESIGN	Web Design
TEAMS.SKILLS.WEB_DEVELOPMENT	Web Development
TEAMS.JOB_FUNCTIONS.BUSINESS_RELATIONSHIP_MANAGEMENT	Business Relationship Management
TEAMS.JOB_FUNCTIONS.COACHING	Coaching
TEAMS.JOB_FUNCTIONS.CONTENT_WRITING	Content Writing
TEAMS.JOB_FUNCTIONS.COMMUNICATION	Communication
TEAMS.JOB_FUNCTIONS.CONSULTING	Consulting
TEAMS.JOB_FUNCTIONS.COORDINATION	Coordination
TEAMS.JOB_FUNCTIONS.DATA_REPORTING_ANALYSIS	Data/Reporting Analysis
TEAMS.JOB_FUNCTIONS.FACILITATION	Facilitation
TEAMS.JOB_FUNCTIONS.FINANCIAL_MANAGEMENT	Financial Management
TEAMS.JOB_FUNCTIONS.GOVERNANCE	Governance
TEAMS.JOB_FUNCTIONS.GRAPHIC_DESIGN	Graphic Design
TEAMS.JOB_FUNCTIONS.INSTRUCTIONAL_DESIGN	Instructional Design
TEAMS.JOB_FUNCTIONS.INTAKE_MANAGEMENT	Intake Management
TEAMS.JOB_FUNCTIONS.LEARNING_DEVELOPMENT	Learning Development
TEAMS.JOB_FUNCTIONS.LEARNING_PLATFORM_ADMINISTRATION	Learning Platform Administration
TEAMS.JOB_FUNCTIONS.LEARNING_STRATEGY	Learning Strategy
TEAMS.JOB_FUNCTIONS.LEARNING_SUPPORT	Learning Support
TEAMS.JOB_FUNCTIONS.LEARNING_TECHNOLOGY	Learning Technology
TEAMS.JOB_FUNCTIONS.LEADERSHIP_DEVELOPMENT	Leadership Development
TEAMS.JOB_FUNCTIONS.MARKETING	Marketing
TEAMS.JOB_FUNCTIONS.MEASUREMENT	Measurement
TEAMS.JOB_FUNCTIONS.PLANNING	Planning
TEAMS.JOB_FUNCTIONS.PORTFOLIO_MANAGEMENT	Portfolio Management
TEAMS.JOB_FUNCTIONS.PROGRAM_MANAGEMENT	Program Management
TEAMS.JOB_FUNCTIONS.PROJECT_MANAGER	Project Management
TEAMS.JOB_FUNCTIONS.QUALITY_ASSURANCE	Quality Assurance
TEAMS.JOB_FUNCTIONS.REPORTING	Reporting
TEAMS.JOB_FUNCTIONS.RESOURCE_MANAGEMENT	Resource Management
TEAMS.JOB_FUNCTIONS.SUBJECT_MATTER_EXPERT	Subject Matter Expert
TEAMS.JOB_FUNCTIONS.TALENT_DEVELOPMENT	Talent Development
TEAMS.JOB_FUNCTIONS.TEAM_MANAGEMENT	Team Management
TEAMS.JOB_FUNCTIONS.TRANSLATION	Translation
TEAMS.JOB_FUNCTIONS.WEB_DEVELOPMENT	Web Development
TEAMS.JOB_FUNCTIONS.VENDOR_MANAGEMENT	Vendor Management
TEAMS.JOB_FUNCTIONS.VIDEO_PRODUCTION	Video Production
TEAMS.JOB_FUNCTIONS.OTHERS	Others
TEAMS.TIME_OFF.UPCOMING_TIME_OFF	Upcoming Time Off
TEAMS.TIME_OFF.HISTORY	History
TEAMS.TIME_OFF.TITLE	Manage Time Off : {user}
TEAMS.TIME_OFF.ADD_REMOVE_TIME_OFF	Add and Remove Time off
TEAMS.TIME_OFF.ADD_NEW_TIME_OFF	Add New Time Off
TEAMS.TIME_OFF.REMOVE	Remove
TEAMS.TIME_OFF.ADD	Add
TEAMS.TIME_OFF.SELECT_TYPE	Select a type of time off
TEAMS.TIME_OFF.START	Start
TEAMS.TIME_OFF.END	End
TEAMS.TIME_OFF.TABLE_HEAD.DATES	Dates
TEAMS.TIME_OFF.TABLE_HEAD.TIME_OFF_TYPE	Time off type
TEAMS.TIME_OFF.EMPTY_TABLE	No time off added
TEAMS.TIME_OFF.TIME_OFF_TYPES.paid_time_off	Personal Time Off
TEAMS.TIME_OFF.TIME_OFF_TYPES.sick_day_off	Sick Leave
TEAMS.TIME_OFF.TIME_OFF_TYPES.custom_holiday	Custom Holiday
TEAMS.TIME_OFF.TIME_OFF_TYPES.vacation	Vacation
TEAMS.TIME_OFF.TIME_OFF_TYPES.parental_leave	Parental Leave
TEAMS.TIME_OFF.TIME_OFF_TYPES.others	Others
TEAMS.TIME_OFF.TIME_OFF_TYPES.UNDEFINED	Not Assigned
TEAMS.CAPACITY_LEGENDS.ALLOCATION	Allocation
TEAMS.CAPACITY_LEGENDS.OVER_ALLOCATION	Over Allocation
TEAMS.CAPACITY_LEGENDS.TIMEOFF_HOLIDAYS	Time Off/Holidays
TEAMS.CAPACITY_LEGENDS.WEEK_CAPACITY	Week's Capacity:
TEAMS.CAPACITY_LEGENDS.HOURS_OCCUPIED	Hours Occupied:
TEAMS.CAPACITY_LEGENDS.AVAILABLE_HOURS	Available Hours:
TEAMS.CAPACITY_LEGENDS.NO_DEFAULT_CAPACITY	Assign capacity
TEAMS.EXPORT_TOOLTIP	Using the checkbox, select the team members you wish to export first.
COUNTRIES.AF	Afghanistan
COUNTRIES.AX	Aland Islands
COUNTRIES.AL	Albania
COUNTRIES.DZ	Algeria
COUNTRIES.AS	American Samoa
COUNTRIES.AD	Andorra
COUNTRIES.AO	Angola
COUNTRIES.AI	Anguilla
COUNTRIES.AQ	Antarctica
COUNTRIES.AG	Antigua And Barbuda
COUNTRIES.AR	Argentina
COUNTRIES.AM	Armenia
COUNTRIES.AW	Aruba
COUNTRIES.AU	Australia
COUNTRIES.AT	Austria
COUNTRIES.AZ	Azerbaijan
COUNTRIES.BS	Bahamas
COUNTRIES.BH	Bahrain
COUNTRIES.BD	Bangladesh
COUNTRIES.BB	Barbados
COUNTRIES.BY	Belarus
COUNTRIES.BE	Belgium
COUNTRIES.BZ	Belize
COUNTRIES.BJ	Benin
COUNTRIES.BM	Bermuda
COUNTRIES.BT	Bhutan
COUNTRIES.BO	Bolivia
COUNTRIES.BQ	Bonaire, Sint Eustatius and Saba
COUNTRIES.BA	Bosnia And Herzegovina
COUNTRIES.BW	Botswana
COUNTRIES.BV	Bouvet Island
COUNTRIES.BR	Brazil
COUNTRIES.IO	British Indian Ocean Territory
COUNTRIES.BN	Brunei Darussalam
COUNTRIES.BG	Bulgaria
COUNTRIES.BF	Burkina Faso
COUNTRIES.BI	Burundi
COUNTRIES.KH	Cambodia
COUNTRIES.CM	Cameroon
COUNTRIES.CA	Canada
COUNTRIES.IC	Canary Islands
COUNTRIES.CV	Cape Verde
COUNTRIES.KY	Cayman Islands
COUNTRIES.CF	Central African Republic
COUNTRIES.TD	Chad
COUNTRIES.CL	Chile
COUNTRIES.CN	China
COUNTRIES.CX	Christmas Island
COUNTRIES.CC	Cocos (Keeling) Islands
COUNTRIES.CO	Colombia
COUNTRIES.KM	Comoros
COUNTRIES.CG	Congo
COUNTRIES.CD	Congo, Democratic Republic
COUNTRIES.CK	Cook Islands
COUNTRIES.CR	Costa Rica
COUNTRIES.CI	Cote D"Ivoire
COUNTRIES.HR	Croatia
COUNTRIES.CU	Cuba
COUNTRIES.CW	Curaçao
COUNTRIES.CY	Cyprus
COUNTRIES.CZ	Czech Republic
COUNTRIES.DK	Denmark
COUNTRIES.DJ	Djibouti
COUNTRIES.DM	Dominica
COUNTRIES.DO	Dominican Republic
COUNTRIES.EC	Ecuador
COUNTRIES.EG	Egypt
COUNTRIES.SV	El Salvador
COUNTRIES.GQ	Equatorial Guinea
COUNTRIES.ER	Eritrea
COUNTRIES.EE	Estonia
COUNTRIES.ET	Ethiopia
COUNTRIES.FK	Falkland Islands (Malvinas)
COUNTRIES.FO	Faroe Islands
COUNTRIES.FJ	Fiji
COUNTRIES.FI	Finland
COUNTRIES.FR	France
COUNTRIES.GF	French Guiana
COUNTRIES.PF	French Polynesia
COUNTRIES.TF	French Southern Territories
COUNTRIES.GA	Gabon
COUNTRIES.GM	Gambia
COUNTRIES.GE	Georgia
COUNTRIES.DE	Germany
COUNTRIES.GH	Ghana
COUNTRIES.GI	Gibraltar
COUNTRIES.GR	Greece
COUNTRIES.GL	Greenland
COUNTRIES.GD	Grenada
COUNTRIES.GP	Guadeloupe
COUNTRIES.GU	Guam
COUNTRIES.GT	Guatemala
COUNTRIES.GG	Guernsey
COUNTRIES.GN	Guinea
COUNTRIES.GW	Guinea-Bissau
COUNTRIES.GY	Guyana
COUNTRIES.HT	Haiti
COUNTRIES.HM	Heard Island & Mcdonald Islands
COUNTRIES.VA	Holy See (Vatican City State)
COUNTRIES.HN	Honduras
COUNTRIES.HK	Hong Kong
COUNTRIES.HU	Hungary
COUNTRIES.IS	Iceland
COUNTRIES.IN	India
COUNTRIES.ID	Indonesia
COUNTRIES.IR	Iran, Islamic Republic Of
COUNTRIES.IQ	Iraq
COUNTRIES.IE	Ireland
COUNTRIES.IM	Isle Of Man
COUNTRIES.IL	Israel
COUNTRIES.IT	Italy
COUNTRIES.JM	Jamaica
COUNTRIES.JP	Japan
COUNTRIES.JE	Jersey
COUNTRIES.JO	Jordan
COUNTRIES.KZ	Kazakhstan
COUNTRIES.KE	Kenya
COUNTRIES.KI	Kiribati
COUNTRIES.KR	Korea
COUNTRIES.KP	North Korea
COUNTRIES.KW	Kuwait
COUNTRIES.KG	Kyrgyzstan
COUNTRIES.LA	Lao People"s Democratic Republic
COUNTRIES.LV	Latvia
COUNTRIES.LB	Lebanon
COUNTRIES.LS	Lesotho
COUNTRIES.LR	Liberia
COUNTRIES.LY	Libyan Arab Jamahiriya
COUNTRIES.LI	Liechtenstein
COUNTRIES.LT	Lithuania
COUNTRIES.LU	Luxembourg
COUNTRIES.MO	Macao
COUNTRIES.MK	Macedonia
COUNTRIES.MG	Madagascar
COUNTRIES.MW	Malawi
COUNTRIES.MY	Malaysia
COUNTRIES.MV	Maldives
COUNTRIES.ML	Mali
COUNTRIES.MT	Malta
COUNTRIES.MH	Marshall Islands
COUNTRIES.MQ	Martinique
COUNTRIES.MR	Mauritania
COUNTRIES.MU	Mauritius
COUNTRIES.YT	Mayotte
COUNTRIES.MX	Mexico
COUNTRIES.FM	Micronesia, Federated States Of
COUNTRIES.MD	Moldova
COUNTRIES.MC	Monaco
COUNTRIES.MN	Mongolia
COUNTRIES.ME	Montenegro
COUNTRIES.MS	Montserrat
COUNTRIES.MA	Morocco
COUNTRIES.MZ	Mozambique
COUNTRIES.MM	Myanmar
COUNTRIES.NA	Namibia
COUNTRIES.NR	Nauru
COUNTRIES.NP	Nepal
COUNTRIES.NL	Netherlands
COUNTRIES.NC	New Caledonia
COUNTRIES.NZ	New Zealand
COUNTRIES.NI	Nicaragua
COUNTRIES.NE	Niger
COUNTRIES.NG	Nigeria
COUNTRIES.NU	Niue
COUNTRIES.NF	Norfolk Island
COUNTRIES.MP	Northern Mariana Islands
COUNTRIES.NO	Norway
COUNTRIES.OM	Oman
COUNTRIES.PK	Pakistan
COUNTRIES.PW	Palau
COUNTRIES.PS	Palestinian Territory, Occupied
COUNTRIES.PA	Panama
COUNTRIES.PG	Papua New Guinea
COUNTRIES.PY	Paraguay
COUNTRIES.PE	Peru
COUNTRIES.PH	Philippines
COUNTRIES.PN	Pitcairn
COUNTRIES.PL	Poland
COUNTRIES.PT	Portugal
COUNTRIES.PR	Puerto Rico
COUNTRIES.QA	Qatar
COUNTRIES.RE	Reunion
COUNTRIES.RO	Romania
COUNTRIES.RU	Russian Federation
COUNTRIES.RW	Rwanda
COUNTRIES.BL	Saint Barthelemy
COUNTRIES.SH	Saint Helena
COUNTRIES.KN	Saint Kitts And Nevis
COUNTRIES.LC	Saint Lucia
COUNTRIES.MF	Saint Martin (French part)
COUNTRIES.PM	Saint Pierre And Miquelon
COUNTRIES.VC	Saint Vincent And Grenadines
COUNTRIES.WS	Samoa
COUNTRIES.SM	San Marino
COUNTRIES.ST	Sao Tome And Principe
COUNTRIES.SA	Saudi Arabia
COUNTRIES.SN	Senegal
COUNTRIES.RS	Serbia
COUNTRIES.SC	Seychelles
COUNTRIES.SL	Sierra Leone
COUNTRIES.SG	Singapore
COUNTRIES.SX	Sint Maarten (Dutch part)
COUNTRIES.SK	Slovakia
COUNTRIES.SI	Slovenia
COUNTRIES.SB	Solomon Islands
COUNTRIES.SO	Somalia
COUNTRIES.ZA	South Africa
COUNTRIES.GS	South Georgia And Sandwich Isl.
COUNTRIES.SS	South Sudan
COUNTRIES.ES	Spain
COUNTRIES.LK	Sri Lanka
COUNTRIES.SD	Sudan
COUNTRIES.SR	Suriname
COUNTRIES.SJ	Svalbard And Jan Mayen
COUNTRIES.SZ	Swaziland
COUNTRIES.SE	Sweden
COUNTRIES.CH	Switzerland
COUNTRIES.SY	Syrian Arab Republic
COUNTRIES.TW	Taiwan
COUNTRIES.TJ	Tajikistan
COUNTRIES.TZ	Tanzania
COUNTRIES.TH	Thailand
COUNTRIES.TL	Timor-Leste
COUNTRIES.TG	Togo
COUNTRIES.TK	Tokelau
COUNTRIES.TO	Tonga
COUNTRIES.TT	Trinidad And Tobago
COUNTRIES.TN	Tunisia
COUNTRIES.TR	Turkey
COUNTRIES.TM	Turkmenistan
COUNTRIES.TC	Turks And Caicos Islands
COUNTRIES.TV	Tuvalu
COUNTRIES.UG	Uganda
COUNTRIES.UA	Ukraine
COUNTRIES.AE	United Arab Emirates
COUNTRIES.GB	United Kingdom
COUNTRIES.US	United States
COUNTRIES.UM	United States Outlying Islands
COUNTRIES.UY	Uruguay
COUNTRIES.UZ	Uzbekistan
COUNTRIES.VU	Vanuatu
COUNTRIES.VE	Venezuela
COUNTRIES.VN	Vietnam
COUNTRIES.VG	Virgin Islands, British
COUNTRIES.VI	Virgin Islands, U.S.
COUNTRIES.WF	Wallis And Futuna
COUNTRIES.EH	Western Sahara
COUNTRIES.YE	Yemen
COUNTRIES.XK	Kosovo
COUNTRIES.ZM	Zambia
COUNTRIES.ZW	Zimbabwe
COUNTRIES.UNDEFINED	Not Assigned
APP_NOTIFICATIONS.REQUEST_QUESTIONS_UPDATED	 updated the request 
APP_NOTIFICATIONS.REQUEST_SUBMITTED	 submitted a request: 
APP_NOTIFICATIONS.ASSIGN_NEW_OWNER	 assigned you as owner of the request form 
APP_NOTIFICATIONS.UNASSIGN_OWNER	 unassigned you as owner of the request form 
APP_NOTIFICATIONS.COMMENT_ADDED	 added a comment to the Request 
APP_NOTIFICATIONS.REQUEST_BACK_IN_REVIEW	The request <b>{requestTitle}</b> has been moved to In Review.
APP_NOTIFICATIONS.REQUEST_CANCELLED	 requested cancellation for the request form  
APP_NOTIFICATIONS.REQUEST_APPROVED	The request form <b>{requestTitle}</b> has been approved by the request owner.
APP_NOTIFICATIONS.REQUEST_DECLINED	The request form <b>{requestTitle}</b> has been declined by the request owner.
APP_NOTIFICATIONS.REQUEST_WAITLISTED	The request <b>{requestTitle}</b> has been waitlisted by the request owner.
APP_NOTIFICATIONS.REQUEST_COMMENT_MENTION	{userName} tagged you in a comment within the Request <b>{requestTitle}</b>.
APP_NOTIFICATIONS.REQUEST_BUSINESS_REVIEWER	 added you as reviewer to the request 
APP_NOTIFICATIONS.TASK_USER_ASSIGNED	{userName} assigned you to the task <b>{taskName}</b>.
APP_NOTIFICATIONS.TASK_USER_UNASSIGNED	{userName} unassigned you from the task <b>{taskName}</b>.
APP_NOTIFICATIONS.TASK_USER_ASSIGNED_OWNER_VIEW	{userName} assigned {actionTargetName} to the task <b>{taskName}</b>.
APP_NOTIFICATIONS.TASK_USER_UNASSIGNED_OWNER_VIEW	{userName} unassigned {actionTargetName} from the task <b>{taskName}</b>.
APP_NOTIFICATIONS.TASK_UPDATED	{userName} updated the task <b>{taskName}</b>.
APP_NOTIFICATIONS.TASK_ACTUAL_HOURS_UPDATED	{userName} updated actual hours of task <b>{taskName}</b>.
APP_NOTIFICATIONS.TASK_STATUS_UPDATED	{userName} updated the status of the task <b>{taskName}</b>.
APP_NOTIFICATIONS.TASK_DISABLED	{userName} {enabled, plural, =0 {disabled} =1 {re-enabled}} the task <b>{taskName}</b>.
APP_NOTIFICATIONS.TASK_DELETED	{userName} deleted the task <b>{taskName}</b>.
APP_NOTIFICATIONS.TASK_DUE_DATE	Only {number, plural, =1 {1 day} =3 {3 days}} left until the task: <b>{taskName}</b> is due.
APP_NOTIFICATIONS.TASK_PAST_DUE_DATE	The task: <b>{taskName}</b> is past its due date.
APP_NOTIFICATIONS.TASK_COMMENT_MENTION	{userName} tagged you in a comment on the Task <b>{taskName}</b>.
APP_NOTIFICATIONS.PROJECT_OWNER_ASSIGNED	{userName} assigned you as owner of the Project <b>{projectName}</b>.
APP_NOTIFICATIONS.PROJECT_OWNER_UNASSIGNED	{userName} unassigned you as owner from the Project <b>{projectName}</b>.
APP_NOTIFICATIONS.PROJECT_STATUS_UPDATED	{userName} updated the status of the Project <b>{projectName}</b> to <b>{projectStatus}</b>
APP_NOTIFICATIONS.PROJECT_UPDATED	{userName} updated the Project <b>{projectName}</b>.
APP_NOTIFICATIONS.PROJECT_COMMENTED	{userName} added a comment to the Project <b>{projectName}</b>.
APP_NOTIFICATIONS.PROJECT_COMMENT_MENTION	{userName} tagged you in a comment within the Project <b>{projectName}</b>.
APP_NOTIFICATIONS.NEW_PROJECT_PARTICIPANT	{userName} assigned you as a member in the Project <b>{projectName}</b> with the project role of <b>{role}</b>.
APP_NOTIFICATIONS.PROJECT_PARTICIPANT_REMOVED	{userName} removed you as a participant from the Project <b>{projectName}</b>.
APP_NOTIFICATIONS.PROJECT_ASSIGNMENT_UPDATED	{userName} updated your assignment as <b>{role}</b> in the Project <b>{projectName}</b>.
APP_NOTIFICATIONS.PROJECT_ASSIGNMENT_REMOVED	{userName} removed your assignment as <b>{role}</b> in the Project <b>{projectName}</b>.
APP_NOTIFICATIONS.PROJECT_START_DATE_THREE_DAYS	Only 3 days left until the project <b>{projectName}</b> should start. Don't forget to change the status to In Progress once it begins!
APP_NOTIFICATIONS.PROJECT_START_DATE_PASSED	The start date for the project <b>{projectName}</b> has passed. Should this project be In Progress?
APP_NOTIFICATIONS.PROJECT_DUE_DATE	Only {number, plural, =7 {1 week} =1 {1 day}} left until the project <b>{projectName}</b> reaches its target completion date.
APP_NOTIFICATIONS.PROJECT_PAST_DUE	The project <b>{projectName}</b> is past its target completion date.
APP_NOTIFICATIONS.BUSINESS_USER_NEW_REGISTRATION	{newUserEmail} just registered as a <b>Business User.</b>
APP_NOTIFICATIONS.TIME_OFF_REMOVED	{triggererName} removed a time off: {dateRange}
APP_NOTIFICATIONS.TIME_OFF_CREATED	{triggererName} added a time off: {dateRange}
APP_NOTIFICATIONS.TIME_OFF_UPDATED	{triggererName} updated a time off: {dateRange}
APP_NOTIFICATIONS.PROJECT_IS_ARCHIVED_UPDATED	{triggererName} {action} the project <b>{projectName}</b>.
APP_NOTIFICATIONS.PROGRAM_UPDATED	{triggererName} updated the program: <b>{programName}</b>
APP_NOTIFICATIONS.PROJECT_LINKED_TO_PROGRAM	{triggererName} linked project <b>{projectName}</b> to program {programName}</b>
APP_NOTIFICATIONS.PROJECT_UNLINKED_FROM_PROGRAM	{triggererName} Unlinked project <b>{projectName}</b> from program <b>{programName}</b>
APP_NOTIFICATIONS.PROGRAM_CLOSED	{triggererName} closed the program: <b>{programName}</b>
APP_NOTIFICATIONS.PROGRAM_DELETED.NO_PROJECTS	{triggererName} has deleted the program <b>{programName}</b>.
APP_NOTIFICATIONS.PROGRAM_DELETED.DELETE_PROJECTS	{triggererName} has deleted the program <b>{programName}</b> with linked projects.
APP_NOTIFICATIONS.PROGRAM_DELETED.UNLINK_PROJECTS	{triggererName} has deleted the program <b>{programName}</b>. However, all linked projects are not impacted by this action.
APP_NOTIFICATIONS.PROGRAM_DELETED.MOVE_PROJECTS	{triggererName} has deleted the program <b>{programName}</b> and moved all {numberOfProjects} {numberOfProjects, plural, =1 {project} other {projects}} to new program <b>{newProgramTitle}</b>.
APP_NOTIFICATIONS.TASK_BUNDLE_UPDATED	{adminName} updated task bundle <b>{bundleTitle}</b>.
APP_NOTIFICATIONS.TASK_BUNDLE_DELETED	{adminName} deleted task bundle <b>{bundleTitle}</b>.
APP_NOTIFICATIONS.V2_PROJECT_PARTICIPANT_ADDED	{triggererName} assigned you as a participant of the Project <b>{projectName}</b>.
APP_NOTIFICATIONS.V2_PROJECT_PARTICIPANT_REMOVED	{triggererName} removed you as a participant from the Project <b>{projectName}</b>.
LANGUAGES.aa	Afar
LANGUAGES.ab	Abkhazian
LANGUAGES.ae	Avestan
LANGUAGES.af	Afrikaans
LANGUAGES.ak	Akan
LANGUAGES.am	Amharic
LANGUAGES.an	Aragonese
LANGUAGES.ar	Arabic
LANGUAGES.as	Assamese
LANGUAGES.av	Avaric
LANGUAGES.ay	Aymara
LANGUAGES.az	Azerbaijani
LANGUAGES.ba	Bashkir
LANGUAGES.be	Belarusian
LANGUAGES.bg	Bulgarian
LANGUAGES.bh	Bihari languages
LANGUAGES.bi	Bislama
LANGUAGES.bm	Bambara
LANGUAGES.bn	Bengali
LANGUAGES.bo	Tibetan
LANGUAGES.br	Breton
LANGUAGES.bs	Bosnian
LANGUAGES.ca	Catalan
LANGUAGES.ce	Chechen
LANGUAGES.ch	Chamorro
LANGUAGES.co	Corsican
LANGUAGES.cr	Cree
LANGUAGES.cs	Czech
LANGUAGES.cu	Old Church Slavonic / Old Bulgarian
LANGUAGES.cv	Chuvash
LANGUAGES.cy	Welsh
LANGUAGES.da	Danish
LANGUAGES.de	German
LANGUAGES.dv	Divehi
LANGUAGES.dz	Dzongkha
LANGUAGES.ee	Ewe
LANGUAGES.el	Greek, Modern (1453-)
LANGUAGES.en	English
LANGUAGES.eo	Esperanto
LANGUAGES.es	Spanish
LANGUAGES.et	Estonian
LANGUAGES.eu	Basque
LANGUAGES.fa	Persian
LANGUAGES.ff	Fulah
LANGUAGES.fi	Finnish
LANGUAGES.fj	Fijian
LANGUAGES.fo	Faroese
LANGUAGES.fr	French
LANGUAGES.fy	Western Frisian
LANGUAGES.ga	Irish
LANGUAGES.gd	Scottish Gaelic
LANGUAGES.gl	Galician
LANGUAGES.gn	Guarani
LANGUAGES.gu	Gujarati
LANGUAGES.gv	Manx
LANGUAGES.ha	Hausa
LANGUAGES.he	Hebrew
LANGUAGES.hi	Hindi
LANGUAGES.ho	Hiri Motu
LANGUAGES.hr	Croatian
LANGUAGES.ht	Haitian
LANGUAGES.hu	Hungarian
LANGUAGES.hy	Armenian
LANGUAGES.hz	Herero
LANGUAGES.ia	Interlingua (International Auxiliary Language Association)
LANGUAGES.id	Indonesian
LANGUAGES.ie	Interlingue
LANGUAGES.ig	Igbo
LANGUAGES.ii	Sichuan Yi
LANGUAGES.ik	Inupiaq
LANGUAGES.io	Ido
LANGUAGES.is	Icelandic
LANGUAGES.it	Italian
LANGUAGES.iu	Inuktitut
LANGUAGES.ja	Japanese
LANGUAGES.jv	Javanese
LANGUAGES.ka	Georgian
LANGUAGES.kg	Kongo
LANGUAGES.ki	Kikuyu
LANGUAGES.kj	Kuanyama
LANGUAGES.kk	Kazakh
LANGUAGES.kl	Greenlandic
LANGUAGES.km	Central Khmer
LANGUAGES.kn	Kannada
LANGUAGES.ko	Korean
LANGUAGES.kr	Kanuri
LANGUAGES.ks	Kashmiri
LANGUAGES.ku	Kurdish
LANGUAGES.kv	Komi
LANGUAGES.kw	Cornish
LANGUAGES.ky	Kirghiz
LANGUAGES.la	Latin
LANGUAGES.lb	Luxembourgish
LANGUAGES.lg	Ganda
LANGUAGES.li	Limburgan
LANGUAGES.ln	Lingala
LANGUAGES.lo	Lao
LANGUAGES.lt	Lithuanian
LANGUAGES.lu	Luba-Katanga
LANGUAGES.lv	Latvian
LANGUAGES.mg	Malagasy
LANGUAGES.mh	Marshallese
LANGUAGES.mi	Maori
LANGUAGES.mk	Macedonian
LANGUAGES.ml	Malayalam
LANGUAGES.mn	Mongolian
LANGUAGES.mr	Marathi
LANGUAGES.ms	Malay
LANGUAGES.mt	Maltese
LANGUAGES.my	Burmese
LANGUAGES.na	Nauru
LANGUAGES.nb	Norwegian Bokmål
LANGUAGES.nd	North Ndebele
LANGUAGES.ne	Nepali
LANGUAGES.ng	Ndonga
LANGUAGES.nl	Dutch
LANGUAGES.nn	Norwegian Nynorsk
LANGUAGES.no	Norwegian
LANGUAGES.nr	South Ndebele
LANGUAGES.nv	Navajo
LANGUAGES.ny	Chichewa
LANGUAGES.oc	Occitan (post 1500)
LANGUAGES.oj	Ojibwa
LANGUAGES.om	Oromo
LANGUAGES.or	Oriya
LANGUAGES.os	Ossetian / Ossetic
LANGUAGES.pa	Panjabi / Punjabi
LANGUAGES.pi	Pali
LANGUAGES.pl	Polish
LANGUAGES.ps	Pashto
LANGUAGES.pt	Portuguese
LANGUAGES.qu	Quechua
LANGUAGES.rm	Romansh
LANGUAGES.rn	Rundi
LANGUAGES.ro	Romanian
LANGUAGES.ru	Russian
LANGUAGES.rw	Kinyarwanda
LANGUAGES.sa	Sanskrit
LANGUAGES.sc	Sardinian
LANGUAGES.sd	Sindhi
LANGUAGES.se	Northern Sami
LANGUAGES.sg	Sango
LANGUAGES.si	Sinhalese
LANGUAGES.sk	Slovak
LANGUAGES.sl	Slovenian
LANGUAGES.sm	Samoan
LANGUAGES.sn	Shona
LANGUAGES.so	Somali
LANGUAGES.sq	Albanian
LANGUAGES.sr	Serbian
LANGUAGES.ss	Swati
LANGUAGES.st	Sotho, Southern
LANGUAGES.su	Sundanese
LANGUAGES.sv	Swedish
LANGUAGES.sw	Swahili
LANGUAGES.ta	Tamil
LANGUAGES.te	Telugu
LANGUAGES.tg	Tajik
LANGUAGES.th	Thai
LANGUAGES.ti	Tigrinya
LANGUAGES.tk	Turkmen
LANGUAGES.tl	Tagalog
LANGUAGES.tn	Tswana
LANGUAGES.to	Tonga (Tonga Islands)
LANGUAGES.tr	Turkish
LANGUAGES.ts	Tsonga
LANGUAGES.tt	Tatar
LANGUAGES.tw	Twi
LANGUAGES.ty	Tahitian
LANGUAGES.ug	Uyghur
LANGUAGES.uk	Ukrainian
LANGUAGES.ur	Urdu
LANGUAGES.uz	Uzbek
LANGUAGES.ve	Venda
LANGUAGES.vi	Vietnamese
LANGUAGES.vo	Volapük
LANGUAGES.wa	Walloon
LANGUAGES.wo	Wolof
LANGUAGES.xh	Xhosa
LANGUAGES.yi	Yiddish
LANGUAGES.yo	Yoruba
LANGUAGES.za	Zhuang
LANGUAGES.zh	Chinese
LANGUAGES.zu	Zulu
LANGUAGES.UNDEFINED	Not Assigned